CRR = "countries/Colmar.txt"
PSS = "countries/Passau.txt"
HEB = "countries/Heb.txt"
MLH = "countries/Mulhouse.txt"
FRB = "countries/Fraiburg.txt"
OFF = "countries/Offenburg.txt"
RTL = "countries/Roitlingen.txt"
KNZ = "countries/Konstanz.txt"
KMP = "countries/Kempten.txt"
MBZ = "countries/Bregenz.txt"
COB = "countries/Coburg.txt"
FLD = "countries/Fulda.txt"
WER = "countries/Werthaim.txt"
WOR = "countries/Worms.txt"
SAA = "countries/Saarbrukken.txt"
ZIG = "countries/Zigen.txt"
IZE = "countries/Izenburg.txt"
ARN = "countries/Arnsberg.txt"
DRT = "countries/Dortmund.txt"
BIL = "countries/Bilefeld.txt"
BNT = "countries/Bentgeim.txt"
GOS = "countries/Goslar.txt"
BRN = "countries/Bernburg.txt"
GET = "countries/Gettingen.txt"
HEL = "countries/Helmstedt.txt"
WIS = "countries/Wismar.txt"
GUS = "countries/Gustrow.txt"
WRN = "countries/Waren.txt"
STL = "countries/Stralzund.txt"
RUG = "countries/Rugen.txt"
STG = "countries/Stargard.txt"
KSA = "countries/Koshalin.txt"
BYT = "countries/Bytom.txt"
GRL = "countries/Gerlitz.txt"
LBN = "countries/Luban.txt"
SVD = "countries/Svidnitsa.txt"
OPL = "countries/Opole.txt"
NIS = "countries/Nisa.txt"
FGT = "countries/Fogtland.txt"
KRN = "countries/Karintia.txt"
KRI = "countries/Kraina.txt"
SLG = "countries/Shlezvig.txt"
JVR = "countries/Javor.txt"